3 DOORS DOWN - HERE WITHOUT YOU
MAGLORE - MANTRA
KELLY OSBOURNE - PAPA DON'T PREACH
OASIS - ALL AROUND THE WORLD
SYSTEM OF A DOWN - CHOP SUEY!
THE BEATLES - DAY TRIPPER
BON JOVI - HAVE A NICE DAY
CHARLIE BROWN JR. - MEU NOVO MUNDO
DAVID BOWIE - ASHES TO ASHES
JIMMY EAT WORLD - THE MIDDLE
VAN HALEN - CAN'T STOP LOVIN' YOU
GREEN DAY - X-KID
THE THE - THIS IS THE DAY
O RAPPA - A FEIRA
AC/DC - WHO MADE WHO
MATCHBOX TWENTY - UNWELL
RAMONES - I WANNA LIVE
EDDIE VEDDER - YOU'VE GOT TO HIDE YOUR LOVE AWAY
CRASH TEST DUMMIES - MMM MMM MMM MMM
PITTY - ME ADORA
OINGO BOINGO - JUST ANOTHER DAY
SUGAR RAY - WHEN IT'S OVER
SLASH - WORLD ON FIRE
SHELTER - HERE WE GO
BASTILLE - BAD BLOOD
TITAS - AA UU
RED HOT CHILI PEPPERS - ROAD TRIPPIN'
BLINK 182 - STORY OF A LONELY GUY
NIRVANA - SAPPY
FAITH NO MORE - FALLING TO PIECES
VOLBEAT - HEAVEN NOR HELL
SIXPENCE NONE THE RICHER - KISS ME
INCUBUS - ANNA MOLLY
IRA! - BEBENDO VINHO
IMAGINE DRAGONS - HEAR ME
QUEEN - A KIND OF MAGIC
U 2 - ANGEL OF HARLEM
THE BLACK KEYS - IN TIME
PEARL JAM - CRAZY MARY
NENHUM DE NOS - CAMILA, CAMILA
THE OFFSPRING - WANT YOU BAD
CHARLATANS - THE ONLY ONE I KNOW
SIOUXSIE AND THE BANSHEES - THE PASSENGER
CITY AND COLOUR - THIRST
AEROSMITH - FULL CIRCLE
THREE DAYS GRACE - I HATE EVERYTHING ABOUT YOU
CAPITAL INICIAL - CAI A NOITE
THE CULT - SHE SELLS SANCTUARY
LINKIN PARK - IN THE END
THE ROLLING STONES - START ME UP
VELVET REVOLVER - SLITHER
THE KILLERS - HUMAN
ALICE IN CHAINS - DOWN IN A HOLE
BARAO VERMELHO - POR VOCE
MIDNIGHT OIL - TRUGANINI
FRANZ FERDINAND - WALK AWAY
KEANE - CRYSTAL BALL
NEW ORDER - BLUE MONDAY
CAKE - THE DISTANCE
CHARLIE BROWN JR. - LUGAR AO SOL
FOO FIGHTERS - BREAKOUT
GEORGE HARRISON - MY SWEET LORD
SHINEDOWN - I'LL FOLLOW YOU
GOO GOO DOLLS - SLIDE
BON JOVI - I'LL BE THERE FOR YOU
LEGIAO URBANA - DEZESSEIS
DAVE MATTHEWS BAND - THE SPACE BETWEEN
DIRE STRAITS - LADY WRITER
PLACEBO - EVERY YOU EVERY ME
CAGE THE ELEPHANT - CIGARETTE DAYDREAMS
RED HOT CHILI PEPPERS - SNOW
TITAS - FAMILIA
SIMPLE MINDS - HYPNOTISED
THE CRANBERRIES - ZOMBIE
SLIPKNOT - VERMILION
INXS - NOT ENOUGH TIME
THE STROKES - LAST NITE
HOODOO GURUS - ANOTHER WORLD
CREED - HIGHER
EAGLE-EYE CHERRY - SAVE TONIGHT
SHOCKING BLUES - VENUS
BECK - LOSER
OS PARALAMAS DO SUCESSO - CALEIDOSCOPIO
NIRVANA - LITHIUM
THE BLACK KEYS - TIGHTEN UP
SUPERTRAMP - TAKE THE LONG WAY HOME
IRON MAIDEN - WASTING LOVE
NOEL GALLAGHER'S HIGH FLYING BIRDS - REVOLUTION SONG
THE VACCINES - HANDSOME
CIRCA WAVES - FOSSIL
ALANIS MORISSETTE - YOU LEARN
RUN DMC/AEROSMITH - WALK THIS WAY
THE ROLLING STONES - DON'T STOP
TONIC - IF YOU COULD ONLY SEE
CHARLIE BROWN JR. - ME ENCONTRA
ARCTIC MONKEYS - FAKE TALES OF SAN FRANCISCO
AC/DC - HARD AS A ROCK
THE KILLERS - SHOT AT THE NIGHT
FAITH NO MORE - EASY
QUEENS OF THE STONE AGE - MAKE IT WIT CHU
THE SMITHS - ASK